struct_A(1).accel	The result isA
struct_A(2).accel	The result isfour
struct_A(3).accel	The result isA
struct_A(4).accel	The result isA
struct_A(5).accel	The result isA
struct_A(6).accel	The result isA
struct_A(7).accel	The result isA
struct_A(8).accel	The result isA
struct_A(9).accel	The result isA
struct_A(10).accel	The result isA
struct_B(1).accel	The result isB
struct_B(2).accel	The result isB
struct_B(3).accel	The result isA
struct_B(4).accel	The result isB
struct_B(5).accel	The result isB
struct_B(6).accel	The result isB
struct_B(7).accel	The result isB
struct_B(8).accel	The result isB
struct_B(9).accel	The result isB
struct_B(10).accel	The result isB
struct_C(1).accel	The result isC
struct_C(2).accel	The result isC
struct_C(3).accel	The result isC
struct_C(4).accel	The result isC
struct_C(5).accel	The result isone
struct_C(6).accel	The result isC
struct_C(7).accel	The result isC
struct_C(8).accel	The result isC
struct_C(9).accel	The result isC
struct_C(10).accel	The result istwo
struct_D(1).accel	The result isB
struct_D(2).accel	The result isD
struct_D(3).accel	The result isD
struct_D(4).accel	The result isD
struct_D(5).accel	The result isD
struct_D(6).accel	The result isD
struct_D(7).accel	The result isD
struct_D(8).accel	The result isD
struct_D(9).accel	The result isD
struct_D(10).accel	The result isD
struct_one(1).accel	The result isone
struct_one(2).accel	The result isone
struct_one(3).accel	The result isone
struct_one(4).accel	The result isone
struct_one(5).accel	The result isone
struct_one(6).accel	The result isone
struct_one(7).accel	The result isone
struct_one(8).accel	The result isone
struct_one(9).accel	The result isone
struct_one(10).accel	The result isone
struct_two(1).accel	The result istwo
struct_two(2).accel	The result istwo
struct_two(3).accel	The result istwo
struct_two(4).accel	The result istwo
struct_two(5).accel	The result istwo
struct_two(6).accel	The result istwo
struct_two(7).accel	The result istwo
struct_two(8).accel	The result istwo
struct_two(9).accel	The result istwo
struct_two(10).accel	The result istwo
struct_three(1).accel	The result isthree
struct_three(2).accel	The result isthree
struct_three(3).accel	The result isthree
struct_three(4).accel	The result isthree
struct_three(5).accel	The result isthree
struct_three(6).accel	The result isthree
struct_three(7).accel	The result isthree
struct_three(8).accel	The result isthree
struct_three(9).accel	The result isthree
struct_three(10).accel	The result isthree
struct_four(1).accel	The result isfour
struct_four(2).accel	The result isfour
struct_four(3).accel	The result isfour
struct_four(4).accel	The result isfour
struct_four(5).accel	The result isfour
struct_four(6).accel	The result isfour
struct_four(7).accel	The result isfour
struct_four(8).accel	The result isD
struct_four(9).accel	The result isfour
struct_four(10).accel	The result isfour
struct_A(11).accel	The result isA
struct_A(12).accel	The result isA
struct_A(13).accel	The result isA
struct_A(14).accel	The result isA
struct_A(15).accel	The result isA
struct_A(16).accel	The result isA
struct_A(17).accel	The result isA
struct_A(18).accel	The result isA
struct_A(19).accel	The result isA
struct_A(20).accel	The result isA
struct_B(11).accel	The result isA
struct_B(12).accel	The result isB
struct_B(13).accel	The result isB
struct_B(14).accel	The result isthree
struct_B(15).accel	The result isB
struct_B(16).accel	The result isB
struct_B(17).accel	The result isB
struct_B(18).accel	The result isB
struct_B(19).accel	The result isB
struct_B(20).accel	The result isB
struct_C(11).accel	The result isC
struct_C(12).accel	The result isC
struct_C(13).accel	The result isone
struct_C(14).accel	The result isC
struct_C(15).accel	The result isC
struct_C(16).accel	The result isC
struct_C(17).accel	The result isC
struct_C(18).accel	The result isC
struct_C(19).accel	The result isC
struct_C(20).accel	The result isC
struct_D(11).accel	The result isD
struct_D(12).accel	The result isD
struct_D(13).accel	The result isD
struct_D(14).accel	The result isD
struct_D(15).accel	The result isB
struct_D(16).accel	The result isD
struct_D(17).accel	The result isD
struct_D(18).accel	The result isD
struct_D(19).accel	The result isD
struct_D(20).accel	The result isD
struct_one(11).accel	The result isone
struct_one(12).accel	The result isone
struct_one(13).accel	The result isone
struct_one(14).accel	The result isone
struct_one(15).accel	The result isone
struct_one(16).accel	The result isone
struct_one(17).accel	The result isone
struct_one(18).accel	The result isone
struct_one(19).accel	The result isone
struct_one(20).accel	The result isone
struct_two(11).accel	The result istwo
struct_two(12).accel	The result istwo
struct_two(13).accel	The result istwo
struct_two(14).accel	The result istwo
struct_two(15).accel	The result istwo
struct_two(16).accel	The result istwo
struct_two(17).accel	The result istwo
struct_two(18).accel	The result istwo
struct_two(19).accel	The result istwo
struct_two(20).accel	The result istwo
struct_three(11).accel	The result isthree
struct_three(12).accel	The result isthree
struct_three(13).accel	The result isthree
struct_three(14).accel	The result isthree
struct_three(15).accel	The result isthree
struct_three(16).accel	The result isfour
struct_three(17).accel	The result isthree
struct_three(18).accel	The result isthree
struct_three(19).accel	The result isthree
struct_three(20).accel	The result isthree
struct_four(11).accel	The result isfour
struct_four(12).accel	The result isfour
struct_four(13).accel	The result isfour
struct_four(14).accel	The result isfour
struct_four(15).accel	The result isfour
struct_four(16).accel	The result isfour
struct_four(17).accel	The result isfour
struct_four(18).accel	The result isfour
struct_four(19).accel	The result isD
struct_four(20).accel	The result isD
struct_A(21).accel	The result isA
struct_A(22).accel	The result isA
struct_A(23).accel	The result isA
struct_A(24).accel	The result isA
struct_A(25).accel	The result isA
struct_A(26).accel	The result isA
struct_A(27).accel	The result isA
struct_A(28).accel	The result isA
struct_A(29).accel	The result isA
struct_A(30).accel	The result isA
struct_B(21).accel	The result isB
struct_B(22).accel	The result isB
struct_B(23).accel	The result isB
struct_B(24).accel	The result isB
struct_B(25).accel	The result isB
struct_B(26).accel	The result isB
struct_B(27).accel	The result isB
struct_B(28).accel	The result isB
struct_B(29).accel	The result isB
struct_B(30).accel	The result isB
struct_C(21).accel	The result isC
struct_C(22).accel	The result istwo
struct_C(23).accel	The result isC
struct_C(24).accel	The result istwo
struct_C(25).accel	The result isC
struct_C(26).accel	The result isC
struct_C(27).accel	The result istwo
struct_C(28).accel	The result istwo
struct_C(29).accel	The result istwo
struct_C(30).accel	The result isC
struct_D(21).accel	The result isD
struct_D(22).accel	The result isD
struct_D(23).accel	The result isD
struct_D(24).accel	The result isD
struct_D(25).accel	The result isD
struct_D(26).accel	The result isD
struct_D(27).accel	The result isD
struct_D(28).accel	The result isD
struct_D(29).accel	The result isD
struct_D(30).accel	The result isD
struct_one(21).accel	The result isone
struct_one(22).accel	The result isone
struct_one(23).accel	The result isone
struct_one(24).accel	The result isone
struct_one(25).accel	The result isone
struct_one(26).accel	The result isone
struct_one(27).accel	The result isone
struct_one(28).accel	The result isone
struct_one(29).accel	The result isone
struct_one(30).accel	The result isone
struct_two(21).accel	The result istwo
struct_two(22).accel	The result istwo
struct_two(23).accel	The result istwo
struct_two(24).accel	The result istwo
struct_two(25).accel	The result istwo
struct_two(26).accel	The result istwo
struct_two(27).accel	The result istwo
struct_two(28).accel	The result istwo
struct_two(29).accel	The result istwo
struct_two(30).accel	The result istwo
struct_three(21).accel	The result isthree
struct_three(22).accel	The result isthree
struct_three(23).accel	The result isthree
struct_three(24).accel	The result isthree
struct_three(25).accel	The result isthree
struct_three(26).accel	The result isthree
struct_three(27).accel	The result isthree
struct_three(28).accel	The result isthree
struct_three(29).accel	The result isthree
struct_three(30).accel	The result isthree
struct_four(21).accel	The result isfour
struct_four(22).accel	The result isfour
struct_four(23).accel	The result isfour
struct_four(24).accel	The result isfour
struct_four(25).accel	The result isD
struct_four(26).accel	The result isfour
struct_four(27).accel	The result isfour
struct_four(28).accel	The result isfour
struct_four(29).accel	The result isfour
struct_four(30).accel	The result isfour
struct_A(31).accel	The result isA
struct_A(32).accel	The result isA
struct_A(33).accel	The result isA
struct_A(34).accel	The result isA
struct_A(35).accel	The result isA
struct_A(36).accel	The result isA
struct_A(37).accel	The result isA
struct_A(38).accel	The result isA
struct_A(39).accel	The result isA
struct_A(40).accel	The result isA
struct_B(31).accel	The result isB
struct_B(32).accel	The result isB
struct_B(33).accel	The result isB
struct_B(34).accel	The result isA
struct_B(35).accel	The result isB
struct_B(36).accel	The result isB
struct_B(37).accel	The result isB
struct_B(38).accel	The result isA
struct_B(39).accel	The result isB
struct_B(40).accel	The result isB
struct_C(31).accel	The result isC
struct_C(32).accel	The result isC
struct_C(33).accel	The result isC
struct_C(34).accel	The result istwo
struct_C(35).accel	The result isC
struct_C(36).accel	The result isC
struct_C(37).accel	The result isC
struct_C(38).accel	The result isC
struct_C(39).accel	The result isC
struct_C(40).accel	The result isC
struct_D(31).accel	The result isD
struct_D(32).accel	The result isD
struct_D(33).accel	The result isD
struct_D(34).accel	The result isD
struct_D(35).accel	The result isD
struct_D(36).accel	The result isD
struct_D(37).accel	The result isD
struct_D(38).accel	The result isD
struct_D(39).accel	The result isD
struct_D(40).accel	The result isD
struct_one(31).accel	The result isone
struct_one(32).accel	The result isone
struct_one(33).accel	The result isone
struct_one(34).accel	The result isone
struct_one(35).accel	The result isone
struct_one(36).accel	The result isone
struct_one(37).accel	The result isone
struct_one(38).accel	The result isone
struct_one(39).accel	The result isone
struct_one(40).accel	The result isone
struct_two(31).accel	The result istwo
struct_two(32).accel	The result istwo
struct_two(33).accel	The result isone
struct_two(34).accel	The result istwo
struct_two(35).accel	The result istwo
struct_two(36).accel	The result istwo
struct_two(37).accel	The result istwo
struct_two(38).accel	The result istwo
struct_two(39).accel	The result istwo
struct_two(40).accel	The result istwo
struct_three(31).accel	The result isthree
struct_three(32).accel	The result isthree
struct_three(33).accel	The result isthree
struct_three(34).accel	The result isthree
struct_three(35).accel	The result isthree
struct_three(36).accel	The result isthree
struct_three(37).accel	The result isthree
struct_three(38).accel	The result isthree
struct_three(39).accel	The result isthree
struct_three(40).accel	The result isthree
struct_four(31).accel	The result isfour
struct_four(32).accel	The result isfour
struct_four(33).accel	The result isfour
struct_four(34).accel	The result isthree
struct_four(35).accel	The result isfour
struct_four(36).accel	The result isfour
struct_four(37).accel	The result isfour
struct_four(38).accel	The result isfour
struct_four(39).accel	The result isfour
struct_four(40).accel	The result isfour
struct_A(41).accel	The result isA
struct_A(42).accel	The result isA
struct_A(43).accel	The result isB
struct_A(44).accel	The result isA
struct_A(45).accel	The result isA
struct_A(46).accel	The result isA
struct_A(47).accel	The result isA
struct_A(48).accel	The result isA
struct_A(49).accel	The result isA
struct_A(50).accel	The result isA
struct_B(41).accel	The result isB
struct_B(42).accel	The result isB
struct_B(43).accel	The result isB
struct_B(44).accel	The result isB
struct_B(45).accel	The result isB
struct_B(46).accel	The result isD
struct_B(47).accel	The result isB
struct_B(48).accel	The result isD
struct_B(49).accel	The result isD
struct_B(50).accel	The result isB
struct_C(41).accel	The result isC
struct_C(42).accel	The result isC
struct_C(43).accel	The result isC
struct_C(44).accel	The result isC
struct_C(45).accel	The result isC
struct_C(46).accel	The result isC
struct_C(47).accel	The result isC
struct_C(48).accel	The result isC
struct_C(49).accel	The result isC
struct_C(50).accel	The result isC
struct_D(41).accel	The result isD
struct_D(42).accel	The result isD
struct_D(43).accel	The result isD
struct_D(44).accel	The result isD
struct_D(45).accel	The result isD
struct_D(46).accel	The result isD
struct_D(47).accel	The result isD
struct_D(48).accel	The result isD
struct_D(49).accel	The result isD
struct_D(50).accel	The result isD
struct_one(41).accel	The result isone
struct_one(42).accel	The result isone
struct_one(43).accel	The result isone
struct_one(44).accel	The result isone
struct_one(45).accel	The result isone
struct_one(46).accel	The result isone
struct_one(47).accel	The result isC
struct_one(48).accel	The result isone
struct_one(49).accel	The result isone
struct_one(50).accel	The result isone
struct_two(41).accel	The result istwo
struct_two(42).accel	The result istwo
struct_two(43).accel	The result istwo
struct_two(44).accel	The result isC
struct_two(45).accel	The result istwo
struct_two(46).accel	The result isC
struct_two(47).accel	The result istwo
struct_two(48).accel	The result istwo
struct_two(49).accel	The result istwo
struct_two(50).accel	The result istwo
struct_three(41).accel	The result isthree
struct_three(42).accel	The result isfour
struct_three(43).accel	The result isthree
struct_three(44).accel	The result isthree
struct_three(45).accel	The result isthree
struct_three(46).accel	The result isthree
struct_three(47).accel	The result isthree
struct_three(48).accel	The result isthree
struct_three(49).accel	The result isthree
struct_three(50).accel	The result isthree
struct_four(41).accel	The result isfour
struct_four(42).accel	The result isfour
struct_four(43).accel	The result isfour
struct_four(44).accel	The result isfour
struct_four(45).accel	The result isfour
struct_four(46).accel	The result isfour
struct_four(47).accel	The result isfour
struct_four(48).accel	The result isfour
struct_four(49).accel	The result isfour
struct_four(50).accel	The result isfour
struct_A(51).accel	The result isA
struct_A(52).accel	The result isA
struct_A(53).accel	The result isA
struct_A(54).accel	The result isA
struct_A(55).accel	The result isA
struct_A(56).accel	The result isA
struct_A(57).accel	The result isA
struct_A(58).accel	The result isB
struct_A(59).accel	The result isA
struct_A(60).accel	The result isA
struct_B(51).accel	The result isB
struct_B(52).accel	The result isB
struct_B(53).accel	The result isB
struct_B(54).accel	The result isB
struct_B(55).accel	The result isB
struct_B(56).accel	The result isB
struct_B(57).accel	The result isD
struct_B(58).accel	The result isD
struct_B(59).accel	The result isB
struct_B(60).accel	The result isD
struct_C(51).accel	The result isC
struct_C(52).accel	The result isC
struct_C(53).accel	The result isC
struct_C(54).accel	The result isC
struct_C(55).accel	The result isC
struct_C(56).accel	The result isC
struct_C(57).accel	The result isC
struct_C(58).accel	The result isC
struct_C(59).accel	The result isC
struct_C(60).accel	The result isC
struct_D(51).accel	The result isD
struct_D(52).accel	The result isD
struct_D(53).accel	The result isD
struct_D(54).accel	The result isfour
struct_D(55).accel	The result isD
struct_D(56).accel	The result isD
struct_D(57).accel	The result isD
struct_D(58).accel	The result isD
struct_D(59).accel	The result isD
struct_D(60).accel	The result isD
struct_one(51).accel	The result isone
struct_one(52).accel	The result isone
struct_one(53).accel	The result isone
struct_one(54).accel	The result isone
struct_one(55).accel	The result isC
struct_one(56).accel	The result isone
struct_one(57).accel	The result isone
struct_one(58).accel	The result isone
struct_one(59).accel	The result isfour
struct_one(60).accel	The result isone
struct_two(51).accel	The result isC
struct_two(52).accel	The result isC
struct_two(53).accel	The result istwo
struct_two(54).accel	The result istwo
struct_two(55).accel	The result istwo
struct_two(56).accel	The result istwo
struct_two(57).accel	The result isC
struct_two(58).accel	The result istwo
struct_two(59).accel	The result istwo
struct_two(60).accel	The result istwo
struct_three(51).accel	The result isthree
struct_three(52).accel	The result isthree
struct_three(53).accel	The result isthree
struct_three(54).accel	The result isthree
struct_three(55).accel	The result isthree
struct_three(56).accel	The result isthree
struct_three(57).accel	The result isthree
struct_three(58).accel	The result isthree
struct_three(59).accel	The result isthree
struct_three(60).accel	The result isthree
struct_four(51).accel	The result isfour
struct_four(52).accel	The result isfour
struct_four(53).accel	The result isfour
struct_four(54).accel	The result isfour
struct_four(55).accel	The result isthree
struct_four(56).accel	The result isD
struct_four(57).accel	The result isfour
struct_four(58).accel	The result isfour
struct_four(59).accel	The result isfour
struct_four(60).accel	The result isfour
struct_A(61).accel	The result isA
struct_A(62).accel	The result isA
struct_A(63).accel	The result isA
struct_A(64).accel	The result isA
struct_A(65).accel	The result isA
struct_A(66).accel	The result isA
struct_A(67).accel	The result isA
struct_A(68).accel	The result isA
struct_A(69).accel	The result isA
struct_A(70).accel	The result isA
struct_B(61).accel	The result isB
struct_B(62).accel	The result isD
struct_B(63).accel	The result isD
struct_B(64).accel	The result isD
struct_B(65).accel	The result isB
struct_B(66).accel	The result isB
struct_B(67).accel	The result isB
struct_B(68).accel	The result isB
struct_B(69).accel	The result isB
struct_B(70).accel	The result isB
struct_C(61).accel	The result isC
struct_C(62).accel	The result isC
struct_C(63).accel	The result isC
struct_C(64).accel	The result isC
struct_C(65).accel	The result isC
struct_C(66).accel	The result isC
struct_C(67).accel	The result isC
struct_C(68).accel	The result isC
struct_C(69).accel	The result isC
struct_C(70).accel	The result isone
struct_D(61).accel	The result isD
struct_D(62).accel	The result isD
struct_D(63).accel	The result isD
struct_D(64).accel	The result isD
struct_D(65).accel	The result isD
struct_D(66).accel	The result isD
struct_D(67).accel	The result isD
struct_D(68).accel	The result isD
struct_D(69).accel	The result isD
struct_D(70).accel	The result isD
struct_one(61).accel	The result isone
struct_one(62).accel	The result isone
struct_one(63).accel	The result isone
struct_one(64).accel	The result isone
struct_one(65).accel	The result isone
struct_one(66).accel	The result isone
struct_one(67).accel	The result isone
struct_one(68).accel	The result isone
struct_one(69).accel	The result isfour
struct_one(70).accel	The result isone
struct_two(61).accel	The result istwo
struct_two(62).accel	The result istwo
struct_two(63).accel	The result istwo
struct_two(64).accel	The result istwo
struct_two(65).accel	The result istwo
struct_two(66).accel	The result istwo
struct_two(67).accel	The result istwo
struct_two(68).accel	The result istwo
struct_two(69).accel	The result isC
struct_two(70).accel	The result istwo
struct_three(61).accel	The result isthree
struct_three(62).accel	The result isthree
struct_three(63).accel	The result isthree
struct_three(64).accel	The result isthree
struct_three(65).accel	The result isthree
struct_three(66).accel	The result isthree
struct_three(67).accel	The result isthree
struct_three(68).accel	The result isthree
struct_three(69).accel	The result isthree
struct_three(70).accel	The result isthree
struct_four(61).accel	The result isfour
struct_four(62).accel	The result isfour
struct_four(63).accel	The result isfour
struct_four(64).accel	The result isfour
struct_four(65).accel	The result isfour
struct_four(66).accel	The result isfour
struct_four(67).accel	The result isfour
struct_four(68).accel	The result isfour
struct_four(69).accel	The result isfour
struct_four(70).accel	The result isfour
struct_A(71).accel	The result isA
struct_A(72).accel	The result isA
struct_A(73).accel	The result isA
struct_A(74).accel	The result isB
struct_A(75).accel	The result isB
struct_A(76).accel	The result isA
struct_A(77).accel	The result isA
struct_A(78).accel	The result isA
struct_A(79).accel	The result isA
struct_A(80).accel	The result isfour
struct_B(71).accel	The result isB
struct_B(72).accel	The result isB
struct_B(73).accel	The result isB
struct_B(74).accel	The result isB
struct_B(75).accel	The result isB
struct_B(76).accel	The result isB
struct_B(77).accel	The result isB
struct_B(78).accel	The result isB
struct_B(79).accel	The result isA
struct_B(80).accel	The result isB
struct_C(71).accel	The result isone
struct_C(72).accel	The result isC
struct_C(73).accel	The result isC
struct_C(74).accel	The result isone
struct_C(75).accel	The result isone
struct_C(76).accel	The result isC
struct_C(77).accel	The result isC
struct_C(78).accel	The result isC
struct_C(79).accel	The result isC
struct_C(80).accel	The result isC
struct_D(71).accel	The result isD
struct_D(72).accel	The result isB
struct_D(73).accel	The result isD
struct_D(74).accel	The result isD
struct_D(75).accel	The result isD
struct_D(76).accel	The result isD
struct_D(77).accel	The result isD
struct_D(78).accel	The result isD
struct_D(79).accel	The result isD
struct_D(80).accel	The result isD
struct_one(71).accel	The result isone
struct_one(72).accel	The result isone
struct_one(73).accel	The result isone
struct_one(74).accel	The result isone
struct_one(75).accel	The result isone
struct_one(76).accel	The result isone
struct_one(77).accel	The result isone
struct_one(78).accel	The result isone
struct_one(79).accel	The result isone
struct_one(80).accel	The result isone
struct_two(71).accel	The result istwo
struct_two(72).accel	The result istwo
struct_two(73).accel	The result istwo
struct_two(74).accel	The result istwo
struct_two(75).accel	The result istwo
struct_two(76).accel	The result istwo
struct_two(77).accel	The result istwo
struct_two(78).accel	The result istwo
struct_two(79).accel	The result istwo
struct_two(80).accel	The result istwo
struct_three(71).accel	The result isthree
struct_three(72).accel	The result isthree
struct_three(73).accel	The result istwo
struct_three(74).accel	The result isthree
struct_three(75).accel	The result isthree
struct_three(76).accel	The result isthree
struct_three(77).accel	The result isthree
struct_three(78).accel	The result isthree
struct_three(79).accel	The result isthree
struct_three(80).accel	The result isthree
struct_four(71).accel	The result isA
struct_four(72).accel	The result isfour
struct_four(73).accel	The result isfour
struct_four(74).accel	The result isfour
struct_four(75).accel	The result isfour
struct_four(76).accel	The result isfour
struct_four(77).accel	The result isfour
struct_four(78).accel	The result isfour
struct_four(79).accel	The result isfour
struct_four(80).accel	The result isfour
struct_A(81).accel	The result isA
struct_A(82).accel	The result isA
struct_A(83).accel	The result isA
struct_A(84).accel	The result isA
struct_A(85).accel	The result isfour
struct_A(86).accel	The result isA
struct_A(87).accel	The result isA
struct_A(88).accel	The result isA
struct_A(89).accel	The result isA
struct_A(90).accel	The result isA
struct_B(81).accel	The result isB
struct_B(82).accel	The result isB
struct_B(83).accel	The result isB
struct_B(84).accel	The result isB
struct_B(85).accel	The result isB
struct_B(86).accel	The result isB
struct_B(87).accel	The result isD
struct_B(88).accel	The result isB
struct_B(89).accel	The result isB
struct_B(90).accel	The result isB
struct_C(81).accel	The result isC
struct_C(82).accel	The result isC
struct_C(83).accel	The result isC
struct_C(84).accel	The result isone
struct_C(85).accel	The result isC
struct_C(86).accel	The result isC
struct_C(87).accel	The result isC
struct_C(88).accel	The result isone
struct_C(89).accel	The result isC
struct_C(90).accel	The result isC
struct_D(81).accel	The result isD
struct_D(82).accel	The result isB
struct_D(83).accel	The result isD
struct_D(84).accel	The result isD
struct_D(85).accel	The result isD
struct_D(86).accel	The result isD
struct_D(87).accel	The result isD
struct_D(88).accel	The result isD
struct_D(89).accel	The result isD
struct_D(90).accel	The result isD
struct_one(81).accel	The result isone
struct_one(82).accel	The result isone
struct_one(83).accel	The result isone
struct_one(84).accel	The result isone
struct_one(85).accel	The result isone
struct_one(86).accel	The result isone
struct_one(87).accel	The result isone
struct_one(88).accel	The result isone
struct_one(89).accel	The result isone
struct_one(90).accel	The result isone
struct_two(81).accel	The result istwo
struct_two(82).accel	The result isC
struct_two(83).accel	The result istwo
struct_two(84).accel	The result istwo
struct_two(85).accel	The result istwo
struct_two(86).accel	The result istwo
struct_two(87).accel	The result isfour
struct_two(88).accel	The result isC
struct_two(89).accel	The result istwo
struct_two(90).accel	The result istwo
struct_three(81).accel	The result isthree
struct_three(82).accel	The result isthree
struct_three(83).accel	The result isthree
struct_three(84).accel	The result isthree
struct_three(85).accel	The result isthree
struct_three(86).accel	The result isthree
struct_three(87).accel	The result isthree
struct_three(88).accel	The result isthree
struct_three(89).accel	The result isthree
struct_three(90).accel	The result isthree
struct_four(81).accel	The result isfour
struct_four(82).accel	The result isfour
struct_four(83).accel	The result isfour
struct_four(84).accel	The result isfour
struct_four(85).accel	The result isfour
struct_four(86).accel	The result isfour
struct_four(87).accel	The result isfour
struct_four(88).accel	The result isfour
struct_four(89).accel	The result isfour
struct_four(90).accel	The result isfour
struct_A(91).accel	The result isA
struct_A(92).accel	The result isA
struct_A(93).accel	The result isA
struct_A(94).accel	The result isA
struct_A(95).accel	The result isA
struct_A(96).accel	The result isA
struct_A(97).accel	The result isA
struct_A(98).accel	The result isA
struct_A(99).accel	The result isD
struct_A(100).accel	The result isA
struct_B(91).accel	The result isB
struct_B(92).accel	The result isB
struct_B(93).accel	The result isB
struct_B(94).accel	The result isD
struct_B(95).accel	The result isB
struct_B(96).accel	The result isB
struct_B(97).accel	The result isB
struct_B(98).accel	The result isB
struct_B(99).accel	The result isA
struct_B(100).accel	The result isB
struct_C(91).accel	The result isC
struct_C(92).accel	The result isC
struct_C(93).accel	The result isC
struct_C(94).accel	The result isC
struct_C(95).accel	The result isC
struct_C(96).accel	The result isC
struct_C(97).accel	The result isC
struct_C(98).accel	The result isC
struct_C(99).accel	The result isC
struct_C(100).accel	The result isC
struct_D(91).accel	The result isD
struct_D(92).accel	The result isD
struct_D(93).accel	The result isD
struct_D(94).accel	The result isD
struct_D(95).accel	The result isD
struct_D(96).accel	The result isD
struct_D(97).accel	The result isD
struct_D(98).accel	The result isD
struct_D(99).accel	The result isD
struct_D(100).accel	The result isD
struct_one(91).accel	The result isone
struct_one(92).accel	The result isone
struct_one(93).accel	The result isone
struct_one(94).accel	The result isone
struct_one(95).accel	The result isone
struct_one(96).accel	The result isone
struct_one(97).accel	The result isone
struct_one(98).accel	The result isone
struct_one(99).accel	The result isone
struct_one(100).accel	The result isone
struct_two(91).accel	The result istwo
struct_two(92).accel	The result istwo
struct_two(93).accel	The result istwo
struct_two(94).accel	The result istwo
struct_two(95).accel	The result istwo
struct_two(96).accel	The result istwo
struct_two(97).accel	The result istwo
struct_two(98).accel	The result istwo
struct_two(99).accel	The result istwo
struct_two(100).accel	The result istwo
struct_three(91).accel	The result isthree
struct_three(92).accel	The result isthree
struct_three(93).accel	The result isthree
struct_three(94).accel	The result isthree
struct_three(95).accel	The result isthree
struct_three(96).accel	The result isthree
struct_three(97).accel	The result isthree
struct_three(98).accel	The result isthree
struct_three(99).accel	The result isthree
struct_three(100).accel	The result isthree
struct_four(91).accel	The result isfour
struct_four(92).accel	The result isfour
struct_four(93).accel	The result isfour
struct_four(94).accel	The result isfour
struct_four(95).accel	The result isfour
struct_four(96).accel	The result isfour
struct_four(97).accel	The result isfour
struct_four(98).accel	The result isfour
struct_four(99).accel	The result isA
struct_four(100).accel	The result isfour
struct_A(101).accel	The result isD
struct_A(102).accel	The result isA
struct_A(103).accel	The result isA
struct_A(104).accel	The result isA
struct_A(105).accel	The result isA
struct_A(106).accel	The result isA
struct_A(107).accel	The result isA
struct_A(108).accel	The result isA
struct_A(109).accel	The result isA
struct_A(110).accel	The result isA
struct_B(101).accel	The result isB
struct_B(102).accel	The result isA
struct_B(103).accel	The result isB
struct_B(104).accel	The result isB
struct_B(105).accel	The result isB
struct_B(106).accel	The result isB
struct_B(107).accel	The result isB
struct_B(108).accel	The result isD
struct_B(109).accel	The result isB
struct_B(110).accel	The result isB
struct_C(101).accel	The result isC
struct_C(102).accel	The result isC
struct_C(103).accel	The result isC
struct_C(104).accel	The result isC
struct_C(105).accel	The result isC
struct_C(106).accel	The result isC
struct_C(107).accel	The result isC
struct_C(108).accel	The result isC
struct_C(109).accel	The result isC
struct_C(110).accel	The result isC
struct_D(101).accel	The result isD
struct_D(102).accel	The result isD
struct_D(103).accel	The result isB
struct_D(104).accel	The result isD
struct_D(105).accel	The result isD
struct_D(106).accel	The result isD
struct_D(107).accel	The result isB
struct_D(108).accel	The result isD
struct_D(109).accel	The result isD
struct_D(110).accel	The result isB
struct_one(101).accel	The result isone
struct_one(102).accel	The result isone
struct_one(103).accel	The result isone
struct_one(104).accel	The result isone
struct_one(105).accel	The result isone
struct_one(106).accel	The result isone
struct_one(107).accel	The result istwo
struct_one(108).accel	The result isone
struct_one(109).accel	The result isone
struct_one(110).accel	The result isone
struct_two(101).accel	The result istwo
struct_two(102).accel	The result isone
struct_two(103).accel	The result istwo
struct_two(104).accel	The result istwo
struct_two(105).accel	The result istwo
struct_two(106).accel	The result istwo
struct_two(107).accel	The result istwo
struct_two(108).accel	The result istwo
struct_two(109).accel	The result istwo
struct_two(110).accel	The result istwo
struct_three(101).accel	The result isthree
struct_three(102).accel	The result isthree
struct_three(103).accel	The result isthree
struct_three(104).accel	The result isthree
struct_three(105).accel	The result isthree
struct_three(106).accel	The result isthree
struct_three(107).accel	The result isthree
struct_three(108).accel	The result isthree
struct_three(109).accel	The result isthree
struct_three(110).accel	The result isC
struct_four(101).accel	The result isfour
struct_four(102).accel	The result isfour
struct_four(103).accel	The result isfour
struct_four(104).accel	The result isfour
struct_four(105).accel	The result isfour
struct_four(106).accel	The result isA
struct_four(107).accel	The result isfour
struct_four(108).accel	The result isfour
struct_four(109).accel	The result isfour
struct_four(110).accel	The result isA
struct_A(111).accel	The result isA
struct_A(112).accel	The result isA
struct_A(113).accel	The result isA
struct_A(114).accel	The result isA
struct_A(115).accel	The result isA
struct_A(116).accel	The result isA
struct_A(117).accel	The result isA
struct_A(118).accel	The result isA
struct_A(119).accel	The result isthree
struct_A(120).accel	The result isA
struct_B(111).accel	The result isA
struct_B(112).accel	The result isB
struct_B(113).accel	The result isB
struct_B(114).accel	The result isB
struct_B(115).accel	The result isB
struct_B(116).accel	The result isA
struct_B(117).accel	The result isB
struct_B(118).accel	The result isB
struct_B(119).accel	The result isB
struct_B(120).accel	The result isB
struct_C(111).accel	The result isC
struct_C(112).accel	The result isC
struct_C(113).accel	The result isC
struct_C(114).accel	The result isC
struct_C(115).accel	The result isC
struct_C(116).accel	The result isC
struct_C(117).accel	The result isC
struct_C(118).accel	The result isC
struct_C(119).accel	The result isC
struct_C(120).accel	The result isC
struct_D(111).accel	The result isD
struct_D(112).accel	The result isB
struct_D(113).accel	The result isD
struct_D(114).accel	The result isD
struct_D(115).accel	The result isB
struct_D(116).accel	The result isD
struct_D(117).accel	The result isD
struct_D(118).accel	The result isB
struct_D(119).accel	The result isD
struct_D(120).accel	The result isB
struct_one(111).accel	The result isone
struct_one(112).accel	The result isone
struct_one(113).accel	The result isone
struct_one(114).accel	The result isone
struct_one(115).accel	The result isone
struct_one(116).accel	The result isone
struct_one(117).accel	The result isone
struct_one(118).accel	The result isone
struct_one(119).accel	The result isone
struct_one(120).accel	The result isC
struct_two(111).accel	The result istwo
struct_two(112).accel	The result istwo
struct_two(113).accel	The result istwo
struct_two(114).accel	The result istwo
struct_two(115).accel	The result istwo
struct_two(116).accel	The result istwo
struct_two(117).accel	The result istwo
struct_two(118).accel	The result istwo
struct_two(119).accel	The result istwo
struct_two(120).accel	The result istwo
struct_three(111).accel	The result isthree
struct_three(112).accel	The result isthree
struct_three(113).accel	The result isthree
struct_three(114).accel	The result isthree
struct_three(115).accel	The result isthree
struct_three(116).accel	The result isthree
struct_three(117).accel	The result isthree
struct_three(118).accel	The result isthree
struct_three(119).accel	The result isthree
struct_three(120).accel	The result isthree
struct_four(111).accel	The result isfour
struct_four(112).accel	The result isfour
struct_four(113).accel	The result isfour
struct_four(114).accel	The result isfour
struct_four(115).accel	The result isfour
struct_four(116).accel	The result isfour
struct_four(117).accel	The result isA
struct_four(118).accel	The result isfour
struct_four(119).accel	The result isfour
struct_four(120).accel	The result isA
struct_A(121).accel	The result isA
struct_A(122).accel	The result isA
struct_A(123).accel	The result isA
struct_A(124).accel	The result isA
struct_A(125).accel	The result isA
struct_A(126).accel	The result isA
struct_A(127).accel	The result isD
struct_A(128).accel	The result isA
struct_A(129).accel	The result isA
struct_A(130).accel	The result isA
struct_B(121).accel	The result isB
struct_B(122).accel	The result isA
struct_B(123).accel	The result isB
struct_B(124).accel	The result isA
struct_B(125).accel	The result isB
struct_B(126).accel	The result isA
struct_B(127).accel	The result isB
struct_B(128).accel	The result isB
struct_B(129).accel	The result isB
struct_B(130).accel	The result isB
struct_C(121).accel	The result isC
struct_C(122).accel	The result isC
struct_C(123).accel	The result isC
struct_C(124).accel	The result isC
struct_C(125).accel	The result isC
struct_C(126).accel	The result isC
struct_C(127).accel	The result isC
struct_C(128).accel	The result isC
struct_C(129).accel	The result isC
struct_C(130).accel	The result isC
struct_D(121).accel	The result isD
struct_D(122).accel	The result isD
struct_D(123).accel	The result isD
struct_D(124).accel	The result isD
struct_D(125).accel	The result isD
struct_D(126).accel	The result isD
struct_D(127).accel	The result isD
struct_D(128).accel	The result isD
struct_D(129).accel	The result isB
struct_D(130).accel	The result isD
struct_one(121).accel	The result isone
struct_one(122).accel	The result isone
struct_one(123).accel	The result isone
struct_one(124).accel	The result isone
struct_one(125).accel	The result isone
struct_one(126).accel	The result isone
struct_one(127).accel	The result isone
struct_one(128).accel	The result isone
struct_one(129).accel	The result isone
struct_one(130).accel	The result isone
struct_two(121).accel	The result istwo
struct_two(122).accel	The result istwo
struct_two(123).accel	The result istwo
struct_two(124).accel	The result istwo
struct_two(125).accel	The result istwo
struct_two(126).accel	The result istwo
struct_two(127).accel	The result istwo
struct_two(128).accel	The result istwo
struct_two(129).accel	The result istwo
struct_two(130).accel	The result isC
struct_three(121).accel	The result isthree
struct_three(122).accel	The result isthree
struct_three(123).accel	The result isthree
struct_three(124).accel	The result isthree
struct_three(125).accel	The result isthree
struct_three(126).accel	The result isthree
struct_three(127).accel	The result isthree
struct_three(128).accel	The result isthree
struct_three(129).accel	The result isthree
struct_three(130).accel	The result isthree
struct_four(121).accel	The result isfour
struct_four(122).accel	The result isfour
struct_four(123).accel	The result isfour
struct_four(124).accel	The result isfour
struct_four(125).accel	The result isfour
struct_four(126).accel	The result isfour
struct_four(127).accel	The result isfour
struct_four(128).accel	The result isfour
struct_four(129).accel	The result isfour
struct_four(130).accel	The result isfour
struct_A(131).accel	The result isA
struct_A(132).accel	The result isA
struct_A(133).accel	The result isA
struct_A(134).accel	The result isA
struct_A(135).accel	The result isA
struct_A(136).accel	The result isA
struct_A(137).accel	The result isA
struct_A(138).accel	The result isA
struct_A(139).accel	The result isA
struct_A(140).accel	The result isA
struct_B(131).accel	The result isB
struct_B(132).accel	The result isfour
struct_B(133).accel	The result isB
struct_B(134).accel	The result isB
struct_B(135).accel	The result isB
struct_B(136).accel	The result isB
struct_B(137).accel	The result isB
struct_B(138).accel	The result isB
struct_B(139).accel	The result isB
struct_B(140).accel	The result isA
struct_C(131).accel	The result isC
struct_C(132).accel	The result isC
struct_C(133).accel	The result isC
struct_C(134).accel	The result isC
struct_C(135).accel	The result isC
struct_C(136).accel	The result isC
struct_C(137).accel	The result isC
struct_C(138).accel	The result isC
struct_C(139).accel	The result isC
struct_C(140).accel	The result isC
struct_D(131).accel	The result isD
struct_D(132).accel	The result isB
struct_D(133).accel	The result isD
struct_D(134).accel	The result isD
struct_D(135).accel	The result isD
struct_D(136).accel	The result isD
struct_D(137).accel	The result isD
struct_D(138).accel	The result isB
struct_D(139).accel	The result isD
struct_D(140).accel	The result isD
struct_one(131).accel	The result isone
struct_one(132).accel	The result isone
struct_one(133).accel	The result isone
struct_one(134).accel	The result isone
struct_one(135).accel	The result isone
struct_one(136).accel	The result isone
struct_one(137).accel	The result isone
struct_one(138).accel	The result isone
struct_one(139).accel	The result istwo
struct_one(140).accel	The result isone
struct_two(131).accel	The result istwo
struct_two(132).accel	The result istwo
struct_two(133).accel	The result istwo
struct_two(134).accel	The result istwo
struct_two(135).accel	The result istwo
struct_two(136).accel	The result istwo
struct_two(137).accel	The result istwo
struct_two(138).accel	The result istwo
struct_two(139).accel	The result istwo
struct_two(140).accel	The result istwo
struct_three(131).accel	The result isthree
struct_three(132).accel	The result isthree
struct_three(133).accel	The result isthree
struct_three(134).accel	The result isfour
struct_three(135).accel	The result isthree
struct_three(136).accel	The result isthree
struct_three(137).accel	The result isthree
struct_three(138).accel	The result isthree
struct_three(139).accel	The result isthree
struct_three(140).accel	The result isthree
struct_four(131).accel	The result isfour
struct_four(132).accel	The result isA
struct_four(133).accel	The result isfour
struct_four(134).accel	The result isfour
struct_four(135).accel	The result isfour
struct_four(136).accel	The result isfour
struct_four(137).accel	The result isfour
struct_four(138).accel	The result isfour
struct_four(139).accel	The result isfour
struct_four(140).accel	The result isfour
